6 2 10 10 15 6 7 14 7
13 8 2 7 16 11 8 10 5
12 16 11 3 11 5 16 6 9
8 10 5 16 12 4 15 4 15
16 14 1 2 1 1 10 5 16
6 10 9 4 3 9 16 11 12
11 6 10 5 16 6 10 1 9
4 9 16 11 6 11 16 11 12
8 15 14 3 9 13 14 3 9